11111111111111111111111
1000T0000000C10010000E1
10000000T111110T1011101
101C0T000100T0001000101
10111110010C000011101T1
1000001T010T00000010001
10T00000010000111010C01
1000000111000010001T001
11111101C00100100011101
1000C10111110010T11C001
1T0001000010T0100011101
10000000001000111000101
10T01111000000001000101
10001C0100100T0010T0101
100T10000011100T10C0T01
1P00100T001C00001000001
11111111111111111111111