11111111111
1000T0000E1
10000001001
100C1111101
111110C0101
10001000T01
10T00010001
10011111101
100C0000101
101100T01C1
10011110101
10010C10111
11110000001
100T0111001
1P00010C001
11111111111