11111111111111111111111
10000000000T0000C00T0E1
1000010C1T000C101000101
11110010101010001000101
1P000T0000C000T000000C1
11111111111111111111111