111111111111
1000T00000E1
100000C10001
100011111001
1111100C1101
100000000001
100111111101
100C00000101
10110000T1C1
100111100101
10010C100111
111100000001
100T01111001
1P00010C0001
111111111111